XXXXXXXXXXXXXXXX 
X X XXXXXXXXXX*X 
X$X XX     XXX X 
X X XX XXX XXX X 
X X XX XXX XXX X 
X   X   XX XXX X
XXX   X        X
XXXXXXXXXXXXXXXX